日	曰
干	千
土	士
未	末
令	今
子	孑	孒	孓
茶	荼
货	贷
己	已	巳
人	入
见	贝
季	李
拔	拨
戈	弋
衣	农
来	采
代	伐
环	坏
免	兔
生	玍
乌	鸟
酒	洒
唱	昌
理	埋
压	庄
西	酉
盖	善	喜
恶	恋	峦
余	佘
广	厂
详	祥
牛	午
瓜	爪
去	丢
厘	匣
击	缶
史	吏
委	萎
石	右
享	亨
天	夫	夭
龙	尤	尢
聚	娶
洗	冼
州	洲
纂	篡
辐	幅
喧	暄
蜇	蛰
防	妨
卵	卯
尘	尖
状	壮	妆
使	便
闭	闲
泌	沁
辛	幸
部	陪
背	育	脊	肓
座	挫
峻	竣
格	恪
优	忧
脏	赃
七	匕
浮	俘
诺	箬
甘	廿
权	杈
水	永
椒	淑
熟	塾
梁	粱
计	汁
吴	昊
映	秧	殃
佣	拥
蹈	稻
勿	匆
拟	似
纯	吨
反	友
列	例	冽	洌
戊	戌	戍
甲	申
暗	喑
埃	挨	唉	凑	揍
斤	斥
缘	喙
校	绞
沉	沈	枕	忱
均	钧
婆	姿
珠	株
输	偷	愈	喻	愉	瑜	榆
试	拭
射	躲
航	舰
仪	议
律	津
塞	寒	赛
九	几
动	运	芸	耘
的	约	钓	灼	趵
力	刀
油	抽	邮	迪	袖	庙	笛	柚
作	炸	诈	昨
乒	乓
通	痛	桶	诵	涌	俑	捅
下	卞
特	持	待	诗	侍	恃	峙
证	症	征	歪	惩	焉
间	问
神	伸	坤	绅
调	雕	稠	绸	凋
语	悟	梧	捂
场	汤	肠	扬	杨
维	准	推	难	堆	雅	雄	锥	椎	唯	雏	稚	帷	惟
测	侧	铡
设	股	投	没	役	般
起	超	越	徒	趋	趣	陡	趟	躺	淌
置	值	植	殖
战	站	粘	贴	帖	黏	沾	玷
烧	绕	浇	挠	饶
治	胎	始	冶	饴
纸	底	低	抵
技	鼓	枝	肢	歧	岐
糖	塘	搪	溏
沙	纱	妙	抄
提	题	堤
源	愿
配	酥	醉	酿	酬
螺	骡	摞
脉	泳	咏
营	莹
钱	针	铜	链	键
微	徴
织	职	识	帜	枳
损	陨
箱	霜	雷	雪	雾	霎	雹	霆
磁	滋	慈
除	斜	涂	途	叙	徐
照	招	沼
远	完	园	玩
乳	礼	轧	札
领	项	顺	倾	顾	须	颈	烦	顽	颌	颇	颐
太	犬
倒	到	致	侄	窒
鲜	鳍	鲸	鳅	鲇	愁	揪
假	霞	遐	瑕	暇
注	住	柱	往	驻
施	他	驰	弛	她
轻	径
减	喊
操	藻	燥	噪	躁	澡
紧	絮
判	拌	伴	叛	绊
振	桭
静	净	挣	睁	铮	琤	狰
增	赠	僧	憎
班	斑	狂	琴	瑟	枉
乱	刮	括	恬
欧	驱	躯	沤	岖
误	娱
障	彰	獐
错	借	蜡	腊	猎	措	惜	鹊
翻	翅	翔	翘	翩	翱
桃	挑	逃	窕
都	署	煮	诸	绪	赌	堵	暑	睹	躇
溶	熔	蓉	榕
综	踪	崇	棕	淙
潜	替	赞
摇	遥	谣	瑶
诊	珍	趁
追	掉	绰	悼
泽	择	译	驿	绎
填	慎
沃	跃	妖	袄
缓	暖	援
闹	柿
薛	薜
锡	赐	踢	剔	惕
驾	努	弩	驽
伪	纬	伟	苇
乏	泛	芝
铸	筹	祷	涛	踌
撞	幢	憧
脆	诡	跪	桅
蝶	泄	碟	屉
逐	琢	啄
鹅	娥	峨
搜	瘦	嫂	飕	嗖	艘
筛	狮
忍	仞
堪	湛	斟
艇	挺	廷	蜓
陀	驼	佗
碗	腕	婉	蜿
掘	倔
脯	膊
渐	暂	崭
掩	淹	俺
址	耻	趾
厮	撕	嘶
檐	瞻
碾	辗
潭	谭
拗	坳
嗓	搡
膛	瞠
啸	潇
桦	烨
瞿	翟
浙	淅
耄	耋
忐	忑
氚	氘
珏	钰